AASLEMA	AA Z L AH M AH
ARE	AA R
ARE(2)	ER
CHROME	K R OW M
CLOSE	K L OW S
CLOSE(2)	K L OW Z
GOOD	G UH D
GOOD(2)	G IH D
GOOGLE	G UW G AH L
HELLO	HH AH L OW
HELLO(2)	HH EH L OW
HELP	HH EH L P
JOB	JH AA B
JOB(2)	JH OW B
KHADEM	K HH AE D AH M
MODE	M OW D
OPEN	OW P AH N
SAKER	S EY K ER
STUDY	S T AH D IY
TA9ES	T IY EY N AY N IY EH S
WHO	HH UW
YOU	Y UW
YOUTUBE	Y UW T UW B